Fortuna Maschinen GmbH:  Divider and rounder Magnus Soft -> Fortuna Maschinen GmbH
STEPHAN:  Parts -> STEPHAN
REED:  Parts -> REED
LBCEQUIPMENT:  Parts -> LBCEQUIPMENT
BERTRAND:  Parts -> BERTRAND
BLOEMHOFINC:  Parts -> BLOEMHOFINC
BENIER:  Parts -> BENIER
Dutchess:  JN SemAutomatic Dough Divider/Rounder 1 ounce to 26 ounce total capacity -> Dutchess
ABS:  Parts -> ABS
EXCELLENT:  Parts -> EXCELLENT
GASPARIN:  Parts -> GASPARIN
Ali:  Dough Divider Rounder -> Ali
UBE:  Parts -> UBE
BACKTECH:  Parts -> BACKTECH
DAVRIK:  Parts -> DAVRIK
EMPIRE:  Parts -> EMPIRE
ALBA:  Parts -> ALBA
Somerset:  SD450 WITH SD400 Floor Model Automatic Dough Divider -> Somerset
KEMPER:  Parts -> KEMPER
BEW:  Parts -> BEW
NUSSEX:  Parts -> NUSSEX
ESCHER:  Parts -> ESCHER
FORTUNA:  Parts -> FORTUNA
OLIVER:  Parts -> OLIVER
eBay:  Divider Rounder In Commercial Dough Rollers & Cutters -> eBay
PICARD:  Parts -> PICARD
RAINIER:  Parts -> RAINIER
STMPRODUCTS:  Parts -> STMPRODUCTS
Thunderbird:  TD36 Dough Rounder and Divider -> Thunderbird
CLEVELAND:  Parts -> CLEVELAND
GEMINI:  Parts -> GEMINI
